{
    "name": "AI Challenge",
    "layout": [
            2, 2, 2, 2, 2, 2, 2, 2, 2, 2, 2, 2, 2,
            2, 1, 0, 0, 1, 0, 0, 1, 1, 1, 0,"P",2,
            2, 0, 2, 0, 2, 0, 2, 0, 2, 1, 2, 0, 2,
            2, 1, 0, 0, 0, 0, 1, 1, 1, 0, 1, 1, 2,
            2, 0, 2, 0, 2, 0, 2, 0, 2, 0, 2, 1, 2,
            2, 1, 0, 1, 1, 0, 0, 0, 1, 0, 0, 1, 2,
            2, 1, 2, 0, 2, 0, 2, 1, 2, 0, 2, 0, 2,
            2, 0, 0, 0, 0, 0, 0, 0, 0, 0, 0, 0, 2,
            2, 0, 2, 0, 2, 1, 2, 0, 2, 0, 2, 0, 2,
            2,"S",0, 1, 0, 0, 0, 0, 0, 0, 0, 0, 2,
            2, 2, 2, 2, 2, 2, 2, 2, 2, 2, 2, 2, 2
    ],
    "monster_dict": {
            "P": "EnemyPlayer"
    },
    "effects_propability": {
            "FlameUpEffect": 0.4
    },
    "grid_size": [13, 11]
}
