{
    "name": "Purple Fluffies",
    "layout": [
            2,  2,  2,  2,  2,  2,  2,  2,  2,  2,  2,  2,  2,  2,  2,  2,  2,  2,  2,  2,
            2,  1, "F", 0,  1,  0, "F", 1,  1,  1,  0, "F", 0,  0,  0,  0,  0,  0,  0,  2,
            2,  0,  2,  0,  2,  0,  2,  0,  2,  0,  2,  0,  0,  0,  0,  0,  0,  0,  0,  2,
            2,  1, "F", 0,  0,  0,  1,  1,  1,  0,  0,  1,  0,  1,  0,  2,  2,  2,  0,  2,
            2,  0,  2,  0,  2,  0,  2, "F", 2,  1,  2,  0,  0,  1,  0,  2, -1,  2,  0,  2,
            2,  1,  0,  1,  1,  0,  0,  0,  0,  0,  0,  1,  0,  1,  0,  2, -1,  2,  0,  2,
            2,  1,  2,  0,  2,  0,  2,  1,  2,  0,  2,  0,  0,  1,  0,  2,  2,  2,  0,  2,
            2,  0,  0,  1,  0,  0,  0,  0,  0,  0,  0,  0,  0,  1,  0,  0,  0,  0,  0,  2,
            2,  0,  2,  0,  2,  1,  2,  0,  2,  0,  2,  0,  0,  1,  0,  2,  2,  2,  0,  2,
            2, "S", 0,  1, "F", 0,  0,  0,  1,  0,  0, "F", 0,  1,  0,  2, -1,  2,  0,  2,
            2,  2,  2,  2,  2,  2,  2,  2,  2,  2,  2,  2,  2,  2,  2,  2, -1,  2,  2,  2
    ],
    "monster_dict": {
            "F": "PurpleFluffy"
    },
    "effects_propability": {
            "FlameUpEffect": 0.4
    },

    "grid_size": [20, 11]
}
